11111111111111111111111111111111
11P1011C0C00000000000000000000C1
10C10000000001011111111111111111
10000000000000011100000010000001
10001000000000011111111111111111
10011100011100011000000000000011
10000000011100011111111111111111
10000000011100011111111111111111
10000000000000010000000000000001
10000000000000011111111111111111
10000000111000011111111111111111
100001E0011100010000000000000011
100000000101C1111111111111111111
10000000000000C111110C0011110011
11111111111110000000011111111111
11111111111111111111111111111111
