1111111
1000001
1C100E1
1CP0101
10000C1
1111111
