1111111
1000001
1C10001
1CPE111
10000C1
1111111
