11111111111
101P0000011
1C1E1001101
10010010001
10010001001
10000000001
1C010100011
11111111111
