1111111111111111
11P1011C0C000001
10C1000000000101
1000000000000001
100010000V000001
1000000000000001
1000000000000001
1000000000000001
1000000000000001
1000000000000001
1000000011100001
100001E000000001
1000000000000111
10000000000000C1
1111111111111111
