1111111
1000001
10000P1
1EC0001
1V10001
100V001
1111111
