1111111111111
1011000000001
1000000000001
1000000000001
1000000000001
1000000000001
1000000000001
1000000000C01
1000000000P01
1000000000E01
1111111111111
