1111111111
1PCE110001
1CCC110001
1000110001
1111111111
